##################################################################### 
||                                                                  ||
||                                                                  ||
||           .....................                                  ||
||                                           .....................  ||
||          ^^^^^^^^^^^^^^^^^^^^^^^^^^^^^^^^^^^^^  ^^^^^^^^^^^^^^^^^||
||                                                                  ||
||                                                                  ||
||^^^^^^^^^^^^^^^^^^^^^^^^^^^^--------^^^^^^^^^^^  ^^^^^^^          ||
||                                          *********               ||
||                  .....................                           ||
||        ^^^^^^^^^^^^^^^^^^^^^^^^^^^^^^^^^^^^^^^  ^^^^^^^^^^^^^^^^^||
||                                                                  ||
||      .....................              .....................    ||
||^^^^^^^^^^^^^^^^^^^^^^^^^^^-----------^^^^^^^^^  ^^^^^^^^         ||
||                                                                  ||
||                                                                  ||
||           ^^^^^^^^^^^^^^^^^^^^^^^^^^^^^^^^^^^^  ^^^^^^^^^^^^^^^^^||
||                                                                  ||
||            .....................                                 ||
||^^^^^^^^^^^^^^^^^^^^^^^^^^^^^^^^^^^^^^-----------^^^^^^^^         ||
||                                                                  ||
|| $               .....................                            ||
##################################################################### 
